--------------------
-                  - 
-                  -
-                  -
-                  -
-     ------       -
-        -----------
----               -
----               -
----               -
---- --            -
---------------    -
-                  -
-                ---
-                  -
-    --------      -
-        -----------
-                ---
----               -
-                  -
-                  -
----------         -
-        ------    -
-             --   -
-                  -
------            --
-                ---
-               ----
-               ----
--------------------