--------------------
-                  - 
-   ------------   -
-     -      -     -
-     -      -     -
-     -      -     -
-     -      -     -
-     -      -     -
-     -      -     -
-     -      -     -
-     -      -     -
-     -      -     -
-     -      -     -
-     ---  ---     -
-     -      -     -
-     -      -     -
-     -  --  -     -
---      --      ---
-       ----       -
-       ----       -
-   ------------   -
-                  -
--                --
--                --
------         -----
-                  -
-       -----      -
-      -------     -
-     ---------    -
--------------------