--------------------
-                  - 
-                  -
-                  -
-                  -
-     ------       -
-        -----------
----               -
----               -
----               -
---- --     ---    -
---------------    -
-                  -
-                ---
-                  -
-    --------      -
-        -----------
-                ---
----               -
-                  - 
-                  -
----------         -
-        --------  -
-                  -
-                  -
------             -
-               ----   
-               ----
-               ----
--------------------